6 12
############
# % # ...  #
# ######## #
#&         #
# .# ! # $ #
############