10 20
####################
#$  # #.       &   #
### ####.  ###### ##
###  & ### ###### ##
# * #  # & ## % # ##
###### # ##### ## ##
# .... # ###  &    #
# ###### ######## ##
#   &     ^ #......#
####################