15 30
##############################
##############################
######### .....##    &  # .###
###        ###### ##   ##  .##
####    ## &      ##       ###
#### ############### #########
### & ###########   & ########
#### ###############  ########
####   ....###          ######
#### ######### ... ###  &  ###
###   ################## #####
##      ##############     ###
##  $   ##############  %  ###
##############################
##############################